

NO              assets/textures/wall.xpm

SO assets/textures/wall.xpm


C 128,128,128
F 139,69,19

WE assets/textures/wall.xpm
EA assets/textures/wall.xpm



1111111
1101011
1010101
110N011
1010101
1100011
1010101
1100011
1010101
1100011
1010101
1100011
1010101
1100011
1010101
1100011
1010101
1100011
1010101
1100011
1010101
1100011
1010101
1100011
1010101
1100011
1010101
1100011
1010101
1100011
1010101
1100011
1010101
1100011
1010101
1100011
1010101
1100011
1010101
1100011
1010101
1100011
1010101
1100011
1010101
1100011
1010101
1100011
1010101
1100011
1010101
1100011
1010101
1100011
1010101
1100011
1010101
1100011
1010101
1100011
1010101
1100011
1010101
1100011
1010101
1100011
1010101
1100011
1010101
1100011
1010101
1100011
1010101
1100011
1010101
1100011
1010101
1100011
1010101
1100011
1010101
1100011
1010101
1100011
1010101
1100011
1010101
1100011
1010101
1100011
1010101
1100011
1010101
1100011
1010101
1100011
1010101
1100011
1010101
1100011
1010101
1100011
1010101
1100011
1010101
1100011
1010101
1100011
1010101
1100011
1010101
1100011
1010101
1100011
1010101
1100011
1010101
1100011
1010101
1100011
1010101
1100011
1010101
1100011
1010101
1100011
1010101
1100011
1010101
1100011
1010101
1100011
1010101
1100011
1010101
1100011
1010101
1100011
1010101
1100011
1010101
1100011
1010101
1100011
1010101
1100011
1010101
1100011
1010101
1100011
1010101
1100011
1010101
1100011
1010101
1100011
1010101
1100011
1010101
1100011
1010101
1100011
1010101
1100011
1010101
1100011
1010101
1100011
1010101
1100011
1010101
1100011
1010101
1100011
1010101
1100011
1010101
1100011
1010101
1100011
1010101
1100011
1010101
1100011
1010101
1100011
1010101
1100011
1010101
1100011
1010101
1100011
1010101
1100011
1010101
1100011
1010101
1100011
1010101
1100011
1010101
1100011
1010101
1100011
1010101
1100011
1010101
1100011
1010101
1100011
1010101
1100011
1010101
1100011
1010101
1100011
1010101
1100011
1010101
1100011
1010101
1100011
1010101
1100011
1010101
1100011
1010101
1100011
1010101
1100011
1010101
1100011
1010101
1100011
1010101
1100011
1010101
1100011
1010101
1100011
1010101
1100011
1010101
1100011
1010101
1111111
