

NO               assets/textures/wall.xpm  

SO assets/textures/wall.xpm



C 128,128,128
F 139,69,19

WE assets/textures/wall.xpm 
EA assets/textures/wall.xpm      



1111111111111111111111111
1000000000110000001000001
1011000001110000010000001
10010000000001S0000000001
100000000011100001110111111111111
111111111011110001110000000000001
111101111111110111000000100011111
11110111111111011101010010001
11000000110101011100000010001
10000000000000000000000000001
10000000000000001101010010001
1100000111010101111101111000111
11110111 1110101 101111010001
11111111 1111111 111111111111
